##########
#S       #
# ###### #
# #    # #
# # ## # #
# # ## # #
#      #E#
##########