###################
#S    #     #     #
#     #        #  #
#  #  #  #        #
#          #  #   #
#     #  #     ##E#
###################
